,Stock A,Stock B,Stock C,Stock D,Stock E
0,0,0,1,0,1
1,0,0,2,2,0
2,0,1,0,1,0
3,1,2,1,2,0
4,2,0,2,0,2
5,0,1,0,1,1
6,0,2,1,0,1
7,0,1,2,0,1
8,0,1,2,2,1
9,2,0,2,1,0
